#### sin 0.0 10.0 0.1
            ///^\\\                                                        ///^\\\                   
          ///     \\\\                                                   ///     \\\\                
        ///          \\                                                //           \\               
       //              \\                                             //             \\\             
     ///                \\                                          //                 \\            
    //                   \\                                        //                   \\           
   //                     \\                                      //                     \\          
  //                       \\                                    //                       \\         
 //                         \\                                  //                         \\        
//                            \                                //                           \\       
/                              \                              //                             \\      
                                \                            //                               \\     
                                 \                          //                                 \\    
                                  \                        //                                   \\   
                                   \\                     //                                     \\  
                                    \\                   //                                        \\
                                     \\                ///                                          \
                                      \\              //                                             
                                       \\\          ///                                              
                                         \\\      ///                                                
                                            \\\v///                                                  
